{
	"difficulty":"moderate",
	"fields":[
[
	[3,7,1,4,2,6,4,8,9],
	[2,6,9,3,4,8,5,7,1],
	[4,8,5,1,9,7,6,2,3],
	[6,2,3,7,5,1,8,9,4],
	[7,9,4,6,8,2,3,1,5],
	[1,5,8,4,3,9,2,6,7],
	[8,4,2,9,7,3,1,5,6],
	[9,3,6,2,1,5,7,4,8],
	[5,1,7,8,6,4,9,3,2]
]

		
	],
	"empty":[
		[1,0,0,0,0,0,0,0,0],
		[1,0,0,0,1,0,1,1,1],	
		[0,0,1,0,0,0,1,1,1],	
		[0,0,0,1,0,0,0,0,0],	
		[1,1,0,0,1,1,0,0,0],	
		[0,0,0,1,0,1,0,1,0],	
		[1,1,0,0,1,0,0,1,1],	
		[1,1,1,0,1,1,0,1,1],	
		[1,1,0,0,0,0,0,1,0]
	]
}
