{
	"difficulty":"moderate",
	"fields":[

	[2,6,3,8,5,7,8,4,1],
	[5,7,1,2,8,4,9,6,3],
	[8,4,9,3,1,6,7,5,2],
	[7,5,2,6,9,3,4,1,8],
	[6,1,8,7,4,5,2,3,9],
	[3,9,4,8,2,1,5,7,6],
	[4,8,5,1,6,2,3,9,7],
	[1,2,7,5,3,9,6,8,4],
	[9,3,6,4,7,8,1,2,5]

		
	],
	"empty":[
		[1,0,0,0,0,0,0,0,0],
		[1,0,0,0,1,0,1,1,1],	
		[0,0,1,0,0,0,1,1,1],	
		[0,0,0,1,0,0,0,0,0],	
		[1,1,0,0,1,1,0,0,0],	
		[0,0,0,1,0,1,0,1,0],	
		[1,1,0,0,1,0,0,1,1],	
		[1,1,1,0,1,1,0,1,1],	
		[1,1,0,0,0,0,0,1,0]
	]
}
